bitter:  Having or being a taste that is sharp, acrid, and unpleasant
sardonic:  Scornfully or cynically mocking
sarcastic:  Expressing or marked by sarcasm
ironic:  Characterized by or constituting irony
mocking:  To treat with ridicule or contempt; deride
scornful: <div class="sds-list"><b>a
satiric:  Of, relating to, or characterized by satire
vituperative:  Using, containing, or marked by harshly abusive censure
scathing:  Bitterly denunciatory; harshly critical: <span class="illustration">"a scathing tract on the uselessness of war"</span> <span class="illustration">Pierre Brodin
confidential:  Done or communicated in confidence; secret
factual:  Of the nature of fact; real
informal:  Not formal or ceremonious; casual: <span class="illustration">an informal gathering of friends; a relaxed, informal manner
facetious:  Playfully jocular; humorous: <span class="illustration">facetious remarks
critical:  Inclined to judge severely and find fault
resigned:  Feeling or marked by resignation; acquiescent: <span class="illustration">"I like trees because they seem more resigned to the way they have to live than other things do"</span> <span class="illustration">Willa Cather
astonished:  To fill with sudden wonder or amazement
objective:  Of or having to do with a material object
naive:  Lacking worldly experience and understanding, especially:<div class="sds-list"><b>a
joyous:  Feeling or causing joy; joyful
spiritual:  Of, relating to, consisting of, or having the nature of spirit; not tangible or material
wistful:  Full of wishful yearning
nostalgic:  A bittersweet longing for things, persons, or situations of the past
humorous:  Full of or characterized by humor; funny: <span class="illustration">a humorous story
mock-serious: **not found**
pedantic:  Characterized by a narrow, often ostentatious concern for book learning and formal rules: <span class="illustration">a pedantic attention to details
didactic:  Intended to instruct
inspiring:  Tending to arouse or exalt: <span class="illustration">an inspiring eulogy
remorseful:  Marked by or filled with remorse
disdainful:  Expressive of disdain; scornful and contemptuous
laudatory:  Expressing or conferring praise: <span class="illustration">a laudatory review of the new play
mystified:  To confuse or puzzle mentally
idyllic:  Of or having the nature of an idyll
compassionate:  Feeling or showing compassion; sympathetic
reverent:  Marked by, feeling, or expressing reverence
lugubrious:  Mournful, dismal, or gloomy, especially to an exaggerated or ludicrous degree
elegiac:  Of, relating to, or involving elegy or mourning or expressing sorrow for that which is irrecoverably past: <span class="illustration">an elegiac lament for youthful ideals
gothic: <div class="sds-list"><b>a
macabre:  Suggesting the horror of death and decay; gruesome: <span class="illustration">macabre tales of war and plague in the Middle Ages
reflective: <div class="sds-list"><b>a
maudlin:  Effusively or tearfully sentimental: <span class="illustration">"displayed an almost maudlin concern for the welfare of animals"</span> <span class="illustration">Aldous Huxley
sentimental: <div class="sds-list"><b>a
patriotic:  Feeling, expressing, or inspired by love for one's country
jingoistic:  Extreme nationalism characterized especially by a belligerent foreign policy; chauvinistic patriotism
detached:  Separated; disconnected: <span class="illustration">a detached part; a detached plug
angry:  Feeling or showing anger; incensed or enraged: <span class="illustration">angry at a rude neighbor; angry with a salesclerk
sad:  Affected or characterized by sorrow or unhappiness
